{
    "7_11.wav": 0.1,
    "7_12.wav": 0.1,
    "7_14.wav": 0.1,
    "8_10.wav": 0.1,
    "8_11.wav": 0.1,
    "8_12.wav": 0.1,
    "9_10.wav": 0.1,
    "9_11.wav": 0.1,
    "9_12.wav": 0.1,
    "9_13.wav": 0.1,
    "10_8.wav": 0.1,
    "10_9.wav": 0.1,
    "10_10.wav": 0.1,
    "10_11.wav": 0.1,
    "10_12.wav": 0.1,
    "10_13.wav": 0.1,
    "11_5.wav": 0.1,
    "11_6.wav": 0.1,
    "11_7.wav": 0.1,
    "11_8.wav": 0.1,
    "11_9.wav": 0.1,
    "11_10.wav": 0.1,
    "11_11.wav": 0.1,
    "12_4.wav": 0.1,
    "12_5.wav": 0.1,
    "12_6.wav": 0.1,
    "12_7.wav": 0.1,
    "12_8.wav": 0.1,
    "12_9.wav": 0.1,
    "12_10.wav": 0.1,
    "12_11.wav": 0.1,
    "12_12.wav": 0.1,
    "13_4.wav": 0.1,
    "13_5.wav": 0.1,
    "13_6.wav": 0.1,
    "13_7.wav": 0.1,
    "13_8.wav": 0.1,
    "13_10.wav": 0.1,
    "14_5.wav": 0.1,
    "14_6.wav": 0.1,
    "14_7.wav": 0.1,
    "14_8.wav": 0.1,
    "15_6.wav": 0.1,
    "15_7.wav": 0.1,
    "15_8.wav": 0.1,
    "15_9.wav": 0.1,
    "16_7.wav": 0.1,
    "16_8.wav": 0.1,
    "16_9.wav": 0.1,
    "7_13.wav": 0.1,
    "8_13.wav": 0.1,
    "9_9.wav": 0.1,
    "9_14.wav": 0.1,
    "11_12.wav": 0.1,
    "13_9.wav": 0.1,
    "13_11.wav": 0.1,
    "14_9.wav": 0.1,
    "14_10.wav": 0.1,
    "17_7.wav": 0.1,
    "17_8.wav": 0.1,
    "8_9.wav": 0.1,
    "8_14.wav": 0.1,
    "16_6.wav": 0.1,
    "16_10.wav": 0.1,
    "10_6.wav": 0.1,
    "11_14.wav": 0.1,
    "15_5.wav": 0.1,
    "6_11.wav": 0.1,
    "9_8.wav": 0.1,
    "10_14.wav": 0.1,
    "13_12.wav": 0.1,
    "15_10.wav": 0.1,
    "16_11.wav": 0.1,
    "8_15.wav": 0.1,
    "14_11.wav": 0.1,
    "17_9.wav": 0.1,
    "7_15.wav": 0.1,
    "9_15.wav": 0.1,
    "10_7.wav": 0.1,
    "14_12.wav": 0.1,
    "6_12.wav": 0.1,
    "7_10.wav": 0.1,
    "11_13.wav": 0.1,
    "12_13.wav": 0.1,
    "12_14.wav": 0.1,
    "17_6.wav": 0.1,
    "10_15.wav": 0.1,
    "11_4.wav": 0.1,
    "11_15.wav": 0.1,
    "13_14.wav": 0.1,
    "10_5.wav": 0.1,
    "13_13.wav": 0.1,
    "10_16.wav": 0.1,
    "9_16.wav": 0.1,
    "8_16.wav": 0.1,
    "12_15.wav": 0.1,
    "14_13.wav": 0.1,
    "9_7.wav": 0.1,
    "15_12.wav": 0.1,
    "15_11.wav": 0.1,
    "11_16.wav": 0.1,
    "13_15.wav": 0.1,
    "17_10.wav": 0.1,
    "8_8.wav": 0.1,
    "10_4.wav": 0.1,
    "14_4.wav": 0.1,
    "15_14.wav": 0.1,
    "17_11.wav": 0.1,
    "14_15.wav": 0.1,
    "18_9.wav": 0.1,
    "12_16.wav": 0.1,
    "14_14.wav": 0.1,
    "15_13.wav": 0.1,
    "6_13.wav": 0.1,
    "7_9.wav": 0.1,
    "15_4.wav": 0.1,
    "7_16.wav": 0.1,
    "9_6.wav": 0.1,
    "18_10.wav": 0.1,
    "16_5.wav": 0.1,
    "8_7.wav": 0.1,
    "12_17.wav": 0.1,
    "16_12.wav": 0.1,
    "11_17.wav": 0.1,
    "18_8.wav": 0.1,
    "6_14.wav": 0.1,
    "19_10.wav": 0.1,
    "10_17.wav": 0.1,
    "13_17.wav": 0.1,
    "18_11.wav": 0.1,
    "13_16.wav": 0.1,
    "6_15.wav": 0.1,
    "19_11.wav": 0.1,
    "9_5.wav": 0.1,
    "14_16.wav": 0.1,
    "13_18.wav": 0.1,
    "15_15.wav": 0.1,
    "14_3.wav": 0.1,
    "14_17.wav": 0.1,
    "13_3.wav": 0.1,
    "16_14.wav": 0.1,
    "14_18.wav": 0.1,
    "15_16.wav": 0.1,
    "15_17.wav": 0.1,
    "12_18.wav": 0.1,
    "6_10.wav": 0.1,
    "11_18.wav": 0.1,
    "12_3.wav": 0.1,
    "6_9.wav": 0.1,
    "9_17.wav": 0.1,
    "7_8.wav": 0.1,
    "16_13.wav": 0.1
}